1 1 1 1 1 1 1 1 1 1 1 1 1 1 1 1
1 0 0 4 2 2 4 0 0 5 5 2 4 0 0 1
1 0 0 4 3 0 0 0 0 5 5 2 0 4 0 1
1 0 0 2 3 4 2 2 2 5 2 2 2 0 0 1
1 0 0 2 3 2 2 2 2 5 2 2 2 0 4 1
1 4 0 0 0 0 0 0 0 0 0 0 0 0 0 1
1 0 4 4 3 4 0 0 0 0 0 0 4 4 4 1
1 0 4 4 3 4 3 3 0 0 0 0 5 5 4 1
1 0 0 0 2 0 0 3 3 3 2 0 0 0 0 1
1 0 0 0 0 0 4 3 3 3 0 0 2 0 0 1
1 4 0 0 0 0 0 0 0 0 0 0 0 0 0 1
1 1 1 1 1 1 1 1 1 1 1 1 1 1 1 1
